Polyethylene	1
Polyurethane	2
Expand Poly	3
Polystyrene	4
Pads	5
Dividers	6
Plates	7
Cut Die	8
Wood	9
Adders	A
Board	B
Cases	C
Pallet/Bale	D
Temp Price	E
Foil	F
Glue	G
Hold	H
Ink	I
Banding	J
Litho	L
Misc. Mat	M
Wood 4 Die	O
PVC/Paper	P
wRap	R
Stitching	S
Tape	T
Coating	V
Wax/Window	W
Rotary Die	X
Flat Die	Y
Trailer	Z
Artwork	?
Blueprint	?
Dies	?
Foam	?
Material	?
Status-1	?
Status-2	?
Status-3	?
Status-4	?
Status-5	?
Status-6	?
Status-7	?
Tooling	?
